{
    "name" : "Alley",
    "tilemap" : [
        [1, 0, 0, 0, 0, 0, 0],
        [0, 0, 0, 0, 0, 0, 0],
        [0, 1, 1, 0, 0, 0, 0],
        [0, 1, 1, 0, 0, 0, 0],
        [0, 1, 1, 1, 0, 0, 0],
        [0, 0, 0, 0, 0, 1, 0],
        [1, 0, 0, 0, 0, 0, 0]
    ],
    "player" : [0, 0]
}
