{
    "name" : "sewer",
    "tilemap" : [
        [0, 0, 0, 0, 0, 0, 0, 0, 0, 2, 1, 3, 3, 1, 2, 0, 0, 0, 0, 0, 0, 0, 0, 0, 0, 0, 0, 0],
        [0, 0, 0, 0, 0, 0, 0, 0, 0, 2, 1, 3, 3, 1, 2, 0, 0, 0, 0, 0, 0, 0, 0, 0, 0, 0, 0, 0],
        [0, 0, 0, 0, 0, 0, 0, 0, 0, 2, 1, 3, 3, 1, 2, 0, 0, 0, 0, 0, 0, 0, 0, 0, 0, 0, 0, 0],
        [0, 2, 2, 2, 2, 2, 2, 2, 2, 2, 1, 3, 3, 1, 2, 0, 0, 0, 0, 0, 0, 0, 0, 0, 0, 0, 0, 0],
        [0, 2, 1, 1, 1, 1, 1, 1, 1, 2, 1, 3, 3, 1, 2, 2, 2, 2, 2, 2, 2, 2, 2, 2, 2, 2, 2, 2],
        [0, 2, 1, 1, 1, 1, 1, 1, 1, 1, 1, 1, 1, 1, 1, 1, 1, 1, 1, 1, 1, 1, 1, 1, 1, 1, 1, 1],
        [0, 2, 1, 1, 1, 1, 1, 1, 1, 2, 1, 3, 3, 1, 3, 3, 3, 3, 3, 1, 1, 3, 3, 3, 3, 1, 3, 3],
        [0, 2, 2, 1, 1, 2, 2, 2, 2, 2, 1, 3, 3, 1, 3, 3, 3, 3, 3, 1, 1, 3, 3, 3, 3, 1, 3, 3],
        [0, 2, 1, 1, 1, 1, 2, 1, 1, 1, 1, 1, 1, 1, 1, 1, 1, 1, 1, 1, 1, 1, 1, 1, 1, 1, 1, 1],
        [0, 2, 1, 1, 1, 1, 2, 1, 1, 2, 1, 3, 3, 1, 2, 2, 1, 2, 2, 2, 2, 2, 2, 1, 2, 2, 2, 2],
        [0, 2, 1, 1, 1, 1, 2, 1, 1, 2, 1, 3, 3, 1, 2, 2, 1, 2, 2, 2, 2, 2, 2, 1, 2, 0, 0, 0],
        [0, 2, 2, 1, 1, 2, 2, 2, 2, 2, 1, 3, 3, 1, 2, 2, 1, 1, 2, 2, 2, 2, 2, 1, 2, 0, 0, 0],
        [2, 2, 1, 1, 1, 1, 2, 1, 1, 2, 1, 3, 3, 1, 2, 2, 2, 1, 2, 2, 1, 1, 1, 1, 2, 0, 0, 0],
        [2, 1, 1, 1, 1, 1, 1, 1, 1, 1, 1, 1, 1, 1, 2, 2, 2, 1, 2, 2, 1, 2, 2, 2, 2, 0, 0, 0],
        [2, 2, 1, 1, 1, 1, 2, 1, 1, 2, 1, 3, 3, 1, 2, 2, 2, 1, 2, 2, 1, 2, 2, 0, 0, 0, 0, 0],
        [0, 2, 2, 1, 1, 2, 2, 2, 2, 2, 1, 3, 3, 1, 2, 2, 1, 1, 1, 1, 1, 1, 2, 0, 0, 0, 0, 0],
        [0, 0, 2, 1, 1, 2, 2, 2, 2, 2, 1, 1, 1, 1, 1, 1, 1, 1, 1, 1, 1, 1, 2, 0, 0, 0, 0, 0],
        [0, 0, 2, 1, 1, 1, 1, 1, 2, 2, 1, 3, 3, 1, 2, 2, 1, 1, 1, 1, 1, 1, 2, 0, 0, 0, 0, 0],
        [0, 0, 2, 1, 1, 1, 1, 1, 2, 2, 1, 3, 3, 1, 2, 2, 2, 2, 1, 1, 2, 2, 2, 0, 0, 0, 0, 0],
        [0, 0, 2, 2, 2, 2, 1, 1, 2, 2, 1, 3, 3, 1, 2, 2, 2, 2, 1, 1, 2, 2, 0, 0, 0, 0, 0, 0],
        [0, 0, 0, 0, 2, 1, 1, 1, 1, 2, 1, 3, 3, 1, 2, 2, 2, 1, 1, 1, 1, 2, 0, 0, 0, 0, 0, 0],
        [0, 0, 0, 0, 2, 1, 0, 0, 1, 1, 1, 1, 1, 1, 1, 1, 1, 1, 1, 1, 1, 2, 0, 0, 0, 0, 0, 0],
        [0, 0, 0, 0, 2, 1, 0, 0, 1, 1, 1, 1, 1, 1, 1, 1, 1, 1, 1, 1, 1, 2, 0, 0, 0, 0, 0, 0],
        [0, 0, 0, 0, 2, 1, 1, 1, 1, 2, 1, 3, 3, 1, 2, 2, 2, 1, 1, 1, 1, 2, 0, 0, 0, 0, 0, 0],
        [0, 0, 0, 0, 2, 2, 2, 2, 2, 2, 1, 3, 3, 1, 2, 2, 2, 2, 2, 2, 2, 2, 0, 0, 0, 0, 0, 0]
    ],
    "player": [6, 3],
    "citizens" : [
        [10, 24],
        [11, 11]
    ],
    "policemen" : [
        [5, 9],
        [20, 20],
        [20, 8]
    ],
    "commandos" : [
        [5, 4],
        [7, 8],
        [20, 8]
    ]
}
